[10,10]
(0,0)
(9,9) | (9,8) | (8,9)
(7,2,1,1)
(5,4,1,1)
(4,5,1,1)
(2,7,1,1)
(2,8,1,1)
(1,8,1,1)
(2,5,1,1)